NO ./textures/bluestone.xpm
SO ./textures/greystone.xpm
WE ./textures/mossy.xpm
EA ./textures/redbrick.xpm

F 0,0,255
C 255,0,0

1111111
1000001
10E00E1
1111111
