NO ./textures/north.xpm
SO ./textures/south.xpm
WE ./textures/west.xpm
EA ./textures/east.xpm

F 0,0,255
C 255,0,0

111 111
1011101
10W0001
1111111
