NO ./textures/greystone.xpm
SO ./textures/greystone.xpm
WE ./textures/greystone.xpm
EA ./textures/greystone.xpm

F 123,123,123
C 30,30,30

11111111111111
1E000000000001
10101111010101
10100001010101
10111101110101
10000000010101
10111111110101
10101100010101
10000001100101
11111111111111
