NO ./textures/north.xpm
SO ./textures/south.xpm
WE ./textures/west.xpm
EA ./textures/east.xpm

F 100,50,100
C 30,30,30

11111111111111111
10000S10100000001
10000010100000001
10000010100000001
11101110111101111
10000000000000001
11101110111011111
10000010100000001
10000010100000001
11111111111111111