NO ./textures/north.xpm
SO ./textures/south.xpm
WE ./textures/west.xpm
EA ./textures/east.xpm

F 100,50,100
C 30,30,30

11111111111111
10000011111111
10N00011111111
11111111111111
